AreaCode,year,DT,MillionDomesticTourists,DR,perGDP,GDP,IP,Population,CPI,PerCapitaDisposableIncome,SoftwareEnterprises,RN,CN,PN,PT,NT,PRN,NRN,PCN,NCN,PPN,NPN
110000,2012,22633.7,226.34,3301.3,93078,17879.4,70.45860919,2069,103.3,33706.46831,2067,116,78,10,13,67,7,109,15,63,3,7
110000,2013,24738.8,247.39,3666.3,101023,19800.81,73.57669756,2115,103.3,40830.04,2682,26,27,39,8,5,12,14,14,13,24,15
110000,2016,28115,281.15,4683,124516,24899.26,77.77624373,2173,101.4,52530,2879,7,2,5,19,0,7,0,2,0,5,0
110000,2017,29353.6,293.536,5122.4,137596,28014.94,78,2170.7,101.9,57230,3026,7,0,7,28,1,7,0,0,0,7,0
110000,2018,30693.2,306.932,5556.2,153095,30319.98,75,2154,102.5,62361,3384,0,0,1,0,5,0,0,0,0,0,1
110000,2019,31883,,5866.2,164563,35371.3,94.06849315,2153.6,102.3,67756,,116,326,509,11,85,7,109,3,323,21,488
110000,2020,18352.4,183.524,2880.9,164889,36102.6,95.20785747,,101.7,,,328006,404736,5064975,32,506,29631,298375,28597,376139,325277,4739698
120000,2016,18811,188.11,2919.4672,73830,17885.39,63.95155302,1562,102.1,34074,465,2079,409,430,385,204,644,1435,99,310,359,71
120000,2017,20769,207.69,3292.13,79837,18549.19,65.00542756,1557,102.1,37022,353,22937,371,3811,238,213,11481,11456,143,228,1787,2024
120000,2018,22651,226.51,3840.89,85757,18809.64,67,1560,102,39506,369,1134,354,387,113,265,527,607,335,19,233,154
120000,2019,24497,244.97,4235.22,90058,14104.28,78.88808664,1561.83,102.7,42404,,7985,5399,8171,2815,468,6757,1228,4844,555,6420,1751
120000,2020,,,,101614,14083.73,90.45421774,,102,,,27343,38058,310170,352,3087,586,26757,438,37620,1636,308534
130000,2011,18626.66,189,1192.2,29631,24515.76,35.86763916,7241,105.7,12214.52047,252,178,73,1,126,371,55,123,21,52,0,1
130000,2012,22911,229,1553.91,31770,26575.01,41.27610116,7288,102.6,13913.98535,247,4685,3725,40,425,518,3704,981,3052,673,38,2
130000,2013,26988,270,1973.82,33187,28442.95,46.21819516,7333,103,15189.64,255,1239,1391,251,425,322,828,411,910,481,189,62
130000,2014,31367.8,313.678,2528.66,34260,29421.15,48.79634332,7384,101.7,16647.4,286,576,515,483,446,477,423,153,331,184,273,210
130000,2015,37059.96,370.5996,3395.6,35653,29806.11,50.24969966,7424.92,100.9,18118.09,284,6349,1277,1286,480,531,6114,235,1036,241,745,541
130000,2016,46532,465.32,4610.13,38233,31827.86,52.95850067,7470,101.5,19725,204,1203,350,320,138,123,1000,203,211,139,177,143
130000,2017,57000,570,6089.6,40883,34016.32,54,7519.52,101.7,21484,218,171,166,182,119,57,127,44,135,31,154,28
130000,2018,68000,680,7580.2,43108,36010.27,56,7556,102.4,23446,218,62,136,179,90,43,54,8,106,30,152,27
130000,2019,78000,780,9248.7,46182,35104.5,58.35638512,7591.97,103,25665,,26,82,304,202,43,25,1,76,6,263,41
130000,2020,,,,48564,36206.9,61.60503751,,102.1,,,65577,136208,1575427,509,260,144,65433,264,135944,333,1575094
140000,2015,36007,360.07,3428.91,32375,12766.49,53.90107311,3664.12,100.6,17853.67,115,192,46,48,115,44,190,2,38,8,37,11
140000,2016,44330,443.3,4227.97,32526,12928.34,55.26887561,3682,101.1,19049,85,665,261,230,57,26,606,59,232,29,197,33
140000,2017,56073,560.73,5338.61,39232,15528.42,55.99470607,3702,101.1,20420,94,2148,1486,2426,478,95,2024,124,613,873,2087,339
140000,2018,70000,700,6699.46,43010,16818.11,57,3718,101.8,21990,99,323,176,770,117,196,189,134,78,98,384,386
140000,2019,83390,833.9,7999.4,45549,17026.68,61.42979697,3729.22,102.7,23828,,10423,953,23852,609,704,9722,701,590,363,22097,1755
140000,2020,33252,332.52,2919.71,50528,17651.93,66.54154728,,102.9,,,27949,64780,1031462,213,381,8660,19289,7517,57263,62844,968618
150000,2012,5887.31,58.87,1080.65,42120,15880.58,38.75735486,2490,103.1,16585.22851,64,962,226,6,44,53,695,267,165,61,6,0
150000,2013,6612.76,66.13,1343.73,45684,16916.5,43.76183632,2498,103.2,18692.89,69,2244,978,138,146,201,1272,972,401,577,70,68
150000,2014,7415,74.15,1744.97,48610,17770.19,45.59228045,2505,101.6,20559.34,82,417,223,204,66,87,249,168,107,116,140,64
150000,2015,8352,83.52,2193.77,51633,17831.51,50.138588,2511.04,101.1,22310.09,81,253,134,397,39,48,182,71,108,26,273,124
150000,2016,9627,96.27,2635.56,54816,18632.57,52.02380952,2520,101.2,24127,72,161,219,251,52,43,122,39,123,96,164,87
150000,2017,11461.2,114.612,3358.59,59017,16096.21,52.0082259,2529,101.7,26212,61,304,346,411,167,64,264,40,295,51,372,39
150000,2018,12856.1,128.561,3924.0132,63772,17289.22,54,2534,101.8,28376,44,1119,418,1674,383,51,1043,76,374,44,1588,86
150000,2019,19317,193.17,4558.5,67852,17212.5,56.84057971,2539.6,102.4,30555,,6489,5567,9864,934,153,4014,2475,2694,2873,7503,2361
150000,2020,12494,124.94,2404.0647,72062,17360,59.97919268,,101.9,,,23044,40178,261223,600,1566,1530,21514,1552,38626,6393,254830
210000,2011,32563.5,325.63,3159.3,37350,22226.7,47.72986539,4383,105.2,16090.71221,1769,172,305,0,196,152,93,79,192,113,0,0
210000,2012,36281.5,362.81,3742,40694,24846.43,50.10252905,4389,102.8,18467.81005,2956,409,390,2,149,75,300,109,318,72,2,0
210000,2013,40427.2,404.27,4432.6,43758,27213.22,55.87699317,4390,102.4,20817.84,4140,1316,872,68,232,144,929,387,585,287,40,28
210000,2014,45925,459.25,5190.2,45608,28626.58,58.75654748,4391,101.7,22820.15,4282,1124,1457,536,456,349,800,324,842,615,353,183
210000,2015,39711,397.11,3620.1,46069,28669.02,62.31745162,4382.4,101.4,24575.58,3610,911,1421,897,356,193,752,159,1190,231,541,356
210000,2016,44873,448.73,4122.2,46557,22037.88,62.60849703,4378,101.6,26040,1892,593,1534,2108,364,118,511,82,1090,444,1741,367
210000,2017,50318.4,503.184,4620.7,49603,23409.24,62.00141912,4369,101.4,27835,1957,1392,3819,4957,356,255,1170,222,2720,1099,3927,1030
210000,2018,56211.4,562.114,5254.8,53872,25315.35,63,4359,102.5,29701,1633,166,1336,896,279,92,147,19,1192,144,745,151
210000,2019,63876,638.76,6102.7,57067,24909.5,76.47182605,4351.7,102.4,31820,,4580,4955,12907,555,580,2517,2063,2619,2336,6742,6165
210000,2020,30150,301.5,2712.2,58872,25115,77.67802585,,102.4,,,26866,46831,445793,397,506,1379,25487,1096,45735,4389,441404
220000,2011,7542,76.41,904.29,28146,10568.83,35.13481074,2749,105.2,13003.17163,816,197,107,0,83,16,148,49,95,12,0,0
220000,2012,8854.28,89.72,1146.89,31558,11939.24,38.61256545,2750,102.5,14833.71804,844,343,270,7,81,10,320,23,254,16,5,2
220000,2013,10241.93,102.41,1441.64,34273,13046.4,42.27123375,2751,102.9,15998.12,908,1298,1081,123,181,119,1046,252,915,166,91,32
220000,2014,12003.55,120.0355,1766.55,36218,13803.14,45.16091528,2752,102,17520.39,956,21212,773,630,121,35,20795,417,751,22,584,46
220000,2015,13982.8,139.828,2220.73,36391,14063.13,47.68788227,2753.32,101.7,18683.7,983,613,323,860,43,2,612,1,321,2,852,8
220000,2016,16416.82,164.1682,2845.94,38011,14886.23,51.29893889,2733,101.6,19967,900,101,190,232,42,24,76,25,132,58,130,102
220000,2017,19093,190.93,3456.5,40077,14944.53,51.99177164,2717,101.6,21368,914,850,442,1148,148,172,617,233,288,154,629,519
220000,2018,22012.64,220.1264,4165.6,41516,15074.62,55,2704,102.1,22798,941,1282,1867,4419,358,391,1028,254,1418,449,3582,837
220000,2019,24696,246.96,4877.89,43475,11726.8,68.89705882,2690.73,103,24563,,1038,1282,3180,917,494,913,125,1027,255,2252,928
220000,2020,15321,153.21,,50800,12311.32,68.82867862,,102.3,,,31383,43860,402326,1729,6467,2526,28857,4535,39325,19546,382780
230000,2011,20237,202.37,1031.9,25915,12582,31.45539906,3834,105.8,12169.86354,387,135,23,4,8,40,9,126,14,9,0,4
230000,2017,16304.17,163.0417,1877,32454,15902.68,49,3788.7,101.3,21206,495,0,0,1,1,0,0,0,0,0,1,0
230000,2018,18100,181,2207.8,33977,16361.62,52,3773,102,22726,111,6,1,18,36,12,6,0,1,0,15,3
230000,2019,22000,220,2640.2,36001,13612.7,67.00768049,3751.3,102.8,24254,,3,1,11,20,8,2,1,0,1,7,4
230000,2020,14000,140,1629,42635,13698.5,67.09239987,,102.3,,,145683,255010,2473841,6,170,2994,142689,7663,247347,50499,2423342
310000,2011,23079,8.7,2786.54,86061,19195.69,64.96383325,2347,105.2,34072.70209,1112,6639,1888,0,69,47,99,6540,48,1840,0,0
310000,2012,25094,9.25,3226.0869,90127,20181.72,67.46680222,2380,102.8,37790.95729,1740,1356,926,1,22,23,1329,27,905,21,0,1
310000,2013,25990.7,7.85,2968,96773,21818.15,69.68511273,2415,102.3,42173.64,2498,66,49,5,5,1,60,6,48,1,5,0
310000,2014,26818,268.18,2950.13,104402,23567.7,70.74304937,2426,102.7,45965.83,2799,186,116,225,96,9,172,14,104,12,207,18
310000,2015,27569,275.69,3004.73,111081,25123.45,73.40794197,2415.27,102.4,49867.17,3030,102,83,224,73,2,102,0,82,1,220,4
310000,2016,29621,296.21,3443.93,123628,27466.15,74.01744018,2420,103.2,54305,1479,13277,7810,16158,163,22,12611,666,6864,946,13927,2231
310000,2017,31845,318.45,4025.13,136109,30632.99,72.99003858,2418,101.7,58988,1497,15872,23482,30633,210,40,13979,1893,19805,3677,21480,9153
310000,2018,33977,339.77,4477.15,148744,32679.87,75,2424,101.6,64183,1677,11939,14609,38230,117,57,8796,3143,10791,3818,22556,15674
310000,2019,36141,361.41,4789.3,156587,38155.32,81.76541717,2428.14,102.5,69442,,117973,58783,227099,176,98,108055,9918,48455,10328,172293,54806
310000,2020,,,,155768,38700.58,93.32797428,,101.7,,,162078,176038,1675575,84,156,17065,145013,18739,157299,121122,1554453
320000,2019,87611.7,876.117,13902.2,122398,99631.52,85.59452119,8070,103.1,41400,,7,22,27,1,8,0,7,0,22,0,27
320000,2020,47174.12,471.7412,8136.31,121231,102700,56.05001106,,102.5,,,68242,110460,1500780,263,780,946,67296,435,110025,2662,1498118
330000,2011,34295,342.95,3785.3,58398,32318.85,55.86673989,5463,105.4,24220.92881,1233,15,3,0,10,7,14,1,3,0,0,0
330000,2012,39124,391.24,4476,62856,34665.33,58.80956728,5477,102.2,27189.19458,1381,105,66,0,56,34,92,13,55,11,0,0
330000,2013,43439,434.39,5202,68036,37756.59,60.56747908,5498,102.3,29774.99,1768,447,371,58,177,169,409,38,289,82,38,20
330000,2014,47875,478.75,5947,72730,40173.03,62.78140886,5508,102.1,32657.57,1699,11679,3440,83,113,71,11586,93,3402,38,68,15
330000,2015,52532,525.32,6720,78768,42886.49,64.92146597,5539,101.4,35537.09,1763,598,240,34,98,54,588,10,228,12,23,11
330000,2016,57300,573,7600,84921,46484.98,64.97316637,5590,101.9,38529,1492,1404,1692,738,211,246,182,1222,315,1377,410,328
330000,2017,62868,628.68,8763.9,93186,51768.26,65,5657,102.1,42046,1669,1645,1084,1809,729,262,1343,302,908,176,1386,423
330000,2018,68386,683.86,9834,101813,56197.15,65,5737,102.3,45840,1600,2084,939,3006,1316,515,1805,279,801,138,2522,484
330000,2019,72180,721.8,10726.93146,107814,62352,98.57882353,5850,102.9,49899,,18233,10739,34626,3814,1877,13194,5039,8618,2121,23861,10765
330000,2020,56978,569.78,8264,100620,64613,93.25139147,,102.3,,,149434,214632,2433260,1652,2838,20883,128551,39522,175110,314725,2118535
340000,2011,22534.8,225.35,1815,27314,15300.65,26.55831099,5968,105.6,11776.40385,166,343,210,2,83,53,272,71,170,40,2,0
340000,2012,29229.1,292.29,2519.1,30683,17212.05,31.21242485,5988,102.3,13606.1481,163,1946,1292,19,295,485,1220,726,785,507,12,7
340000,2013,33601.1,336.01,2903.2,34256,19229.34,35.65624067,6030,102.4,15154.31,337,1058,895,241,188,217,651,407,518,377,105,136
340000,2014,37898.8,378.988,3309.7,37184,20848.75,36.57794802,6083,101.6,16795.52,430,414,909,351,180,164,237,177,187,722,162,189
340000,2015,44403.7,444.037,3980.5,38983,22005.63,38.98365779,6143.6,101.3,18362.57,418,312,261,409,88,15,297,15,253,8,391,18
340000,2016,52241.2,522.412,4763.6,42641,24117.87,43.91542931,6196,101.8,19998,298,1139,762,2375,250,180,602,537,410,352,1388,987
340000,2017,62627,626.27,6002.4,47671,27018,47.00150285,6255,101.2,21863,269,2723,1829,5431,595,243,1977,746,1435,394,3951,1480
340000,2018,72147,721.47,7030,54078,30006.82,50,6324,102,23984,336,3275,2182,6578,1181,469,2391,884,1516,666,4566,2012
340000,2019,81955,819.55,8291.5,58072,37114,57.14543664,6365.9,102.7,26415,,4742,3442,14534,2261,1297,2783,1959,2179,1263,8819,5715
340000,2020,47046,470.46,4221.5,63426,38680.6,58.04586405,,102.7,,,38646,101000,851052,972,2504,4090,34556,6332,94668,75541,775511
350000,2016,30864,308.64,3495.21,76778,28519.15,69.12751678,3874,101.7,27608,2563,2937,901,1786,55,1,2895,42,886,15,1758,28
350000,2017,37534,375.34,4571,86943,32182.09,69,3911,101.2,30048,2926,4130,2492,5510,272,468,3722,408,2126,366,4831,679
350000,2018,45139,451.39,6033,98542,35804.04,69,3941,101.5,32644,2825,5397,2338,5942,403,524,4880,517,1944,394,5029,913
350000,2019,52697,526.97,7393.43,106966,42395,78.12666183,3973,102.6,35616,,7913,5281,9275,542,455,2668,5245,1385,3896,5474,3801
350000,2020,36981,369.81,4928,105818,43903.89,80.9901466,,102.2,,,22549,35566,376210,578,534,2391,20158,2021,33545,5732,370478
360000,2013,24846,248.46,1863.6,31686,14410.19,32.4624349,4522,102.5,15099.68,139,1075406,425402,162373,570,261,298640,776766,178653,246749,113493,48880
360000,2014,31134.47,311.3447,2615.17,34571,15714.63,33.97062191,4542,102.3,16734.17,141,1922,5950,344,217,119,1426,496,1750,4200,235,109
360000,2015,38392.18,383.9218,3600.45,36850,16723.78,38.52699408,4565.63,101.5,18437.11,135,1020,802,1415,299,197,795,225,565,237,1051,364
360000,2016,46913.39,469.1339,4954.48,40159,18364.41,44.31620209,4592,102,20110,113,1337,744,2232,468,263,1087,250,508,236,1438,794
360000,2017,57064.59,570.6459,6392.56,43868,20006.31,46.99898315,4622,102,22031,152,1494,1096,1886,477,237,1291,203,939,157,1623,263
360000,2018,68344.05,683.4405,8095.8,49013,21984.78,51,4648,102.1,24080,149,772,870,1472,272,20,748,24,835,35,1443,29
360000,2019,79078.28,790.7828,9596.7,52865,24757.5,52.46899911,4666.1,102.9,26262,,9870,3761,21287,412,1240,2040,7830,1000,2761,6922,14365
360000,2020,,,,56871,25691.5,85.22944438,,102.6,,,20053,26337,197061,328,2809,1464,18589,2609,23728,14737,182324
370000,2015,65045.35,650.4535,6505.1,56312,63002.33,48.63331153,9847.16,101.2,22703.19,3750,4483,215,437,186,304,4255,228,69,146,185,252
370000,2016,70716.48,707.1648,7399.6,59375,67008.19,52.34744144,9947,102.1,24685,3965,8152,713,1994,969,1261,4538,3614,274,439,751,1243
370000,2017,77966.18696,779.6618696,8491.5,63162,72634.15,55,10005.83,101.5,26930,3741,468,421,1327,416,207,376,92,315,106,1028,299
370000,2018,85899.3,858.993,9663.28,66472,76469.67,57,10047,102.5,29205,4124,677,545,1194,480,1228,526,151,379,166,806,388
370000,2019,93288,932.88,11087.27645,70129,71067.5,68.42667722,10070.21,103.2,31597,,4302,5643,19896,666,3995,1022,3280,938,4705,2635,17261
370000,2020,57670,576.7,6005.32,72151,73129,66.47122479,,102.8,,,166035,259322,2535360,1145,4162,8849,157186,12229,247093,41792,2493568
410000,2012,36129.2,361.29,2881.3156,30820,29599.31,30.3635977,9406,102.5,13005.92708,275,83,66,1,55,63,58,25,46,20,1,0
410000,2013,40898,408.98,3391.98,33618,32191.3,34.87600057,9413,102.9,14203.71,331,95,118,14,32,23,75,20,98,20,9,5
410000,2014,45642,456.42,4366.2,36686,34938.24,36.81644765,9436,101.9,15695.18,291,144,86,72,12,13,58,86,39,47,43,29
410000,2015,51621,516.21,5035.29,39209,37002.16,39.06118143,9480,101.3,17124.75,286,4376,1734,2030,140,222,3962,414,1530,204,1552,478
410000,2016,58013,580.13,5764.06,42341,40160.01,43.11791859,9532,101.9,18443,178,3239,1527,4665,226,364,2801,438,1248,279,4080,585
410000,2017,66204.44,662.0444,6751,46959,44552.83,45,9559,101.4,20170,188,358,372,839,204,672,165,193,222,150,569,270
410000,2018,78261.22,782.6122,8052,52114,48055.86,48,9605,102.3,21964,177,6493,3101,21823,1446,714,5437,1056,2570,531,18598,3225
410000,2019,89803,898.03,9517,55825,54259.2,48.003232,10952,103,23903,,3011,2526,13861,1130,2457,1216,1795,996,1530,4135,9726
410000,2020,,0,,55435,54997.07,49.63786339,,102.8,,,53395,115899,1375430,462,2570,3915,49480,1964,113935,17189,1358241
420000,2011,27154.87,271.55,1931.8,34738,19632.26,36.97785497,5758,105.8,12845.17058,694,84,36,0,49,46,56,28,25,11,0,0
420000,2012,34230,342.3,2553.55,39163,22250.45,39.95500952,5779,102.9,14800.75465,1251,74,102,3,31,248,18,56,8,94,0,3
420000,2013,40621.04,406.21,3130.13,43838,24791.83,42.95568201,5799,102.8,16472.46,2368,321649,142494,741,631,354,320890,759,142026,468,610,131
420000,2014,46900,469,3675.98,48630,27379.22,45.13411279,5816,102,18283.23,2501,764,1000,387,170,38,671,93,891,109,333,54
420000,2015,50668.24,506.6824,4206.02,52015,29550.19,46.53507648,5851.5,101.5,20025.56,2497,6922,1477,1452,463,81,6788,134,1364,113,1342,110
420000,2016,56930.83,569.3083,4764.18,56836,32297.91,51.1299915,5885,102.2,21787,2547,694,528,1363,133,61,601,93,413,115,1196,167
420000,2017,63499.86,634.9986,5372.79,63180,35478.09,53,5902,101.5,23757,2622,3195,3327,1828,263,116,2698,497,2984,343,1550,278
420000,2018,53556.28,535.5628,6021.42,71109,39366.55,57,5917,101.9,25815,2447,3939,3600,2537,315,145,3409,530,3406,194,2214,323
420000,2019,60143.7,601.437,6743.99,76712,45828.31,51.66694787,5917,103.1,28319,,5688,5863,19865,1346,1029,4616,1072,4688,1175,14177,5688
420000,2020,43694.43,436.9443,4365.89,74440,43443.46,56.07310705,,102.7,,,4184025,1338778,21180857,217,4214,128308,4055717,74368,1264410,2441145,18739712
430000,2011,25099.66,251,1718.2,28734,19669.56,5.12462854,6596,105.5,12104.4067,558,74,59,1,45,74,18,56,23,36,1,0
430000,2012,30281.78,302.82,2175.458075,32048,22154.23,33.13787011,6639,102,13914.37144,535,3972,2206,9,283,353,1392,2580,592,1614,6,3
430000,2013,35827.46,358.27,2630.9,35328,24621.67,36.02068574,6691,102.5,16004.9,650,9151,3594,284,733,888,6448,2703,2786,808,203,81
430000,2014,40982.98,409.8298,3002,38549,27037.32,38.27977035,6737,101.9,17621.74,610,677,552,311,437,415,540,137,447,105,225,86
430000,2015,47104.68,471.0468,3660,42216,28902.21,39.58407968,6783.03,101.4,19317.49,463,30591,3852,886,257,92,4222,26369,2570,1282,645,241
430000,2016,56306.98231,563.0698231,4641,45356,31244.68,44.16593374,6822,101.9,21115,355,987,621,4033,147,67,781,206,449,172,2546,1487
430000,2017,66611.89885,666.1189885,7173,49448,33902.96,45.99966473,6860.15,101.4,23103,425,57,67,200,54,18,41,16,53,14,158,42
430000,2018,75000,750,8255.12,52809,36425.78,50,6899,102,25241,569,15467,771,1527,442,135,13375,2092,702,69,1319,208
430000,2019,82687.15,826.8715,9613.4,57746,39752.12,45.14909639,6918.4,102.9,27680,,75481,4253,11225,1813,624,58865,16616,3695,558,9601,1624
430000,2020,69319.03,693.1903,8258.42,62900,41781.49,48.79458239,,102.3,,,1828808,630912,9387187,1456,4264,281628,1547180,50475,580437,1006652,8380535
440000,2011,15537,210.68,3931.71,50676,53210.28,59.97229851,10505,105.3,21026.64896,4290,1946,633,12,234,234,1171,775,314,319,6,6
440000,2012,17411,239.12,4807.86,54038,57067.92,62.55427601,10594,102.8,23809.08714,4340,4356,1660,15,389,371,2768,1588,1123,537,4,11
440000,2013,19338,267.53,5708.64,58860,62474.79,65.68959038,10644,102.5,23420.75,4196,10951,4226,897,829,502,6695,4256,3077,1149,539,358
440000,2014,29400,294,6801.25,63809,67809.85,67.94106677,10724,102.3,25684.96,4486,52845,12857,2322,779,1070,50995,1850,12125,732,1495,827
440000,2015,32800,328,7976.6,69283,72812.55,71.60106922,10849,101.5,27858.86,4437,48927,12257,5322,1014,536,46822,2105,10889,1368,4078,1244
440000,2016,36200,362,9200.3,75213,79512.05,72.95208655,10999,102.3,30296,3631,5339,4096,4432,1134,759,4605,734,2845,1251,3120,1312
440000,2017,40700,407,10667.14,82686,89705.23,75,11169,101.5,33003,4414,1336,2674,2432,1288,645,1121,215,2060,614,1976,456
440000,2018,45300,453,12253.3,88781,97277.77,74,11346,102.2,35810,4584,8865,3344,8491,2108,481,7304,1561,2998,346,4536,3955
440000,2019,,0,13740.02,94448,107671.07,68.36416046,11521,103.4,39014,,1934571,232343,2595546,2934,1950,1865831,68740,191022,41321,2330312,265234
440000,2020,,,4528.31,88210,110760.94,68.54562738,,102.6,,,402969,461649,6007566,969,3191,52212,350757,35767,425882,209925,5797641
450000,2010,14074,140.74,898.1,18070,9569.85,26.59436009,4610,103,9551.6,96,14,11,0,17,4,9,5,8,3,0,0
450000,2011,17257,172.51,1209.46,22258,11720.87,29.12809473,4645,105.9,10926.77419,131,115,62,4,184,20,94,21,50,12,3,1
450000,2012,20778,207.78,1578.9,24238,13035.1,33.87441264,4682,103.2,12639.18334,220,228,210,6,121,53,215,13,179,31,5,1
450000,2013,24264,242.64,1961.32,26483,14449.9,37.59271032,4719,102.2,14082.3,235,1233,687,154,176,69,1126,107,632,55,135,19
450000,2014,28565,285.65,2495,28687,15672.89,38.8725284,4754,1021,15557.08,241,363,168,89,489,118,252,111,119,49,68,21
450000,2015,33661,336.61,3136.3939,30990,16803.12,42.38949124,4796,101.5,16873.42,206,510,110,193,1440,699,437,73,83,27,151,42
450000,2016,40419,404.19,4048.3545,33458,18245.07,45.74204217,4838,101.6,18305,163,262,98,152,92,371,166,96,60,38,113,39
450000,2017,51811.86,518.1186,5420.4375,36595,18523.26,48,4885,101.6,19905,174,829,1153,1577,835,592,687,142,688,465,1023,554
450000,2018,67767,677.67,7436.1,40012,20352.51,50,4926,102.3,21485,141,3796,3753,5853,1853,1709,3398,398,2610,1143,4389,1464
450000,2019,86995,869.95,9998.82,42964,21237.14,60.67844239,4960,103.7,23328,,4821,5734,21758,2934,1708,3224,1597,3440,2294,12649,9109
450000,2020,66092,660.92,7262.1,44309,22156.69,66.8698944,,102.8,,,76222,63227,352307,2673,6522,12655,63567,13498,49729,118798,233509
460000,2012,3238.8,32.38,356.79,31627,2855.54,43.31396988,887,103.2,14376.32156,35,206,126,0,25,20,199,7,111,15,0,0
460000,2013,3596.87,35.97,408.05,34974,3177.56,45.90742561,895,102.8,15733.28,37,84,52,5,12,18,75,9,37,15,4,1
460000,2014,4722.99,47.2299,490.2,38349,3500.72,46.59760039,903,102.4,17476.46,62,28,20,14,8,21,11,17,7,13,5,9
460000,2015,5275.68,52.7568,528.08,41164,3702.76,51.16268857,910.82,101,18978.97,122,5,1,8,11,9,3,2,0,1,3,5
460000,2016,5948.7031,59.487031,610.27,44752,4044.51,51.25408942,917,102.8,20653,143,16,6,22,15,15,4,12,2,4,8,14
460000,2017,6633.0691,66.330691,766.77,48810,4462.54,51.01322157,926,102.8,22553,182,73,197,399,168,91,61,12,195,2,329,70
460000,2018,7500.10101,75.0010101,898.14,52801,4832.05,51,934,102.5,24579,237,13519,6016,10110,1256,514,9518,4001,4051,1965,6707,3403
460000,2019,8167.61,81.6761,991.81,56740,5308.94,79.80904523,944.72,103.4,26679,,13060,12289,39532,3554,1993,9801,3259,10104,2185,32302,7230
460000,2020,6432.68,64.3268,865.24,55131,5523.39,84.21936759,,102.3,,,113085,72666,997305,1737,4814,3103,109982,5537,67129,29676,967629
500000,2013,30597.4,305.974,1679.166,44049,12783.26,43.53535354,2970,102.7,16568.67,616,721,211,89,432,44,644,77,203,8,76,13
500000,2014,34650.92,346.5092,1912.57,49062,14262.6,45.36337501,2991,101.8,18351.9,832,74573,54325,589,111,212,5175,69398,5015,49310,254,335
500000,2015,38885.1,388.851,2251.31,53398,15717.27,47.90240507,3016.55,101.3,20110.11,941,11272,4896,3162,461,507,9271,2001,2818,2078,1501,1661
500000,2016,44769.55,447.6955,2645.21,59433,17558.76,51.04986877,3048,101.8,22034,1201,1313,1552,2340,187,200,1072,241,1113,439,1777,563
500000,2017,53871.86,538.7186,3176.5459,65538,19424.73,53,3075,101,24153,1457,1944,2294,4090,138,17,1939,5,2292,2,4083,7
500000,2018,3935.69,39.3569,4199.236219,69901,20363.19,55,3102,102,26386,1495,3292,1285,1006,946,279,3264,28,1245,40,909,97
500000,2019,65389,653.89,5733.982582,75828,23605.77,72.71643664,3124.32,102.7,28920,,5461,2528,5522,505,163,3529,1932,2045,483,3898,1624
500000,2020,,,,78170,25002.79,73.81738859,,102.3,,,56979,127190,2324198,141,135,62,56917,84,127106,373,2323825
510000,2011,34977.8,350,2410.6,26163,21026.68,27.68944099,8050,105.8,11051.73957,724,0,2,1,0,2,0,0,0,2,0,1
510000,2012,43500,440,3229.83,29669,23872.8,31.72283995,8076,102.5,12793.4626,968,574,255,4,124,45,456,118,213,42,3,1
510000,2013,48700,490,3830.04,32772,26392.07,34.9697792,8107,102.7,14230.99,1291,39246,11030,138,435,300,30636,8610,8484,2546,92,46
510000,2014,53549.69,535.4969,4838.34,35565,28536.66,37.12439498,8140,101.6,15749.01,1461,2674,2004,5735,554,246,2073,601,1587,417,4556,1179
510000,2015,58500.63,585.0063,6137.6,37129,30053.1,39.7367138,8204,101.5,17220.96,1772,2397,1141,8702,270,290,1081,1316,718,423,4397,4305
510000,2016,63025,630.25,7600.52,40251,32680.5,43.27039458,8262,101.9,18808,222,2779,1944,7570,316,635,776,2003,486,1458,2208,5362
510000,2017,66924,669.24,8825.39,45768,36980.22,45,8302,101.4,20580,1731,10910,3320,17998,693,701,8158,2752,1978,1342,12951,5047
510000,2018,70198.44234,701.9844234,10012.7,51556,40678.13,48,8341,101.7,22461,1818,10284,11093,23799,1127,684,8136,2148,8237,2856,16340,7459
510000,2019,75081.57623,750.8157623,11454.5,55472,46615.82,70.21913543,8375,103.2,24703,,55441,33174,139475,3956,1598,34122,21319,23197,9977,59620,79854
510000,2020,,,,58126,48598.8,75.07705173,,103.2,,,926481,603990,5029970,2869,6499,41515,884966,42367,561623,264219,4765751
520000,2011,16961,169.61,1420.7,16165,5701.84,24.21642566,3469,105.1,8463.666013,172,800,672,0,74,49,209,591,149,523,0,0
520000,2012,21331,213.3,1849.49,19394,6852.2,28.44374539,3484,102.7,9831.73099,181,924,1017,42,213,52,825,99,896,121,41,1
520000,2013,26683.58,266.84,2358.18,22825,8086.86,32.72210198,3502,102.5,11083.06,210,572,456,71,156,25,548,24,424,32,62,9
520000,2014,32049.44,320.4944,2882.66,26171,9266.39,34.83426643,3508,102.4,12371.06,222,156494,35030,1742,423,201,2997,153497,947,34083,433,1309
520000,2015,37535.92,375.3592,3500.46,29956,10502.56,38.13571327,3529.5,101.8,13696.61,245,1525,1046,1165,202,111,345,1180,418,628,340,825
520000,2016,53038.23,530.3823,5011.94,33291,11734.43,42.86919831,3555,101.4,15121,91,2487,7713,5993,314,233,317,2170,434,7279,524,5469
520000,2017,74290.64,742.9064,7097.91,38137,13540.83,45,3580,100.9,16704,225,3249,7418,3402,256,178,1095,2154,719,6699,682,2720
520000,2018,96700,967,9449.58,42767,14806.45,49,3600,101.8,18430,240,5480,1740,2112,221,68,1020,4460,884,856,1211,901
520000,2019,,,12296.03,46433,16769.34,45.73544699,3622.95,102.4,20397,,3495,2170,5636,241,219,1326,2169,1188,982,1629,4007
520000,2020,,,,46267,17826.56,45.21772939,,102.6,,,37473,41123,639538,2237,3670,7938,29535,6237,34886,58708,580830
530000,2012,19630.28,196.3028,1579.49,23891,10309.47,28.35372398,4659,102.7,11570.13769,99,47,129,3,50,97,9,38,37,92,0,3
530000,2013,23972.35,240,1961.55,27447,11832.31,32.60359322,4687,103.1,12577.87,103,1544,730,122,346,407,1157,387,528,202,73,49
530000,2014,28116.49,281.1649,2516.87,29874,12814.59,34.85436687,4714,102.4,13772.21,109,1019,798,595,904,504,684,335,575,223,454,141
530000,2015,32343.95,323.4395,3104.37,31642,13619.17,37.13779577,4741.8,101.9,15222.57,106,35769,4661,868,416,314,35443,326,4535,126,652,216
530000,2016,42519.33,425.1933,4536.54,34416,14869.95,39.65625655,4771,101.5,16720,1158,9699,3936,1475,220,364,9396,303,3616,320,808,667
530000,2017,56672.12,566.7212,6682.58,38629,16376.34,41,4801,100.9,18348,170,4263,13529,10654,387,297,3713,550,12145,1384,8621,2033
530000,2018,68100,681,8698.97,43366,17881.12,43,4830,101.6,20084,176,9464,12321,23668,740,720,5804,3660,7127,5194,16154,7514
530000,2019,80000,800,10679.51,47944,23223.75,44.35935511,4858.3,102.5,22082,,11631,10604,72168,1984,1214,8669,2962,7840,2764,58451,13717
530000,2020,,,,51975,24521.9,46.97162219,,103.6,,,84467,62684,423581,2538,6082,11654,72813,10095,52589,47170,376411
540000,2017,2527.08,25.2708,366.25,40408,1310.92,42,337,101.6,15457,,320,106,513,87,11,312,8,98,8,480,33
540000,2018,3321.11,33.2111,473.8,45476,1477.63,47,344,101.7,17286,,5020,654,2487,458,93,4933,87,541,113,2240,247
540000,2019,3957.96,39.5796,540.44,48902,1697.82,57.92243767,350.56,102.3,19501,,1161,632,2136,466,149,1062,99,568,64,1765,371
540000,2020,,,,52345,1902.74,59.83606557,,102.2,,,41958,47711,668833,318,306,5012,36946,3065,44646,26274,642559
610000,2012,22941,232.76,1609.5,37733,14453.68,41.32594742,3753,102.8,13250.19459,659,27,17,0,27,18,17,10,7,10,0,0
610000,2013,28161,282,2031.1,42318,16205.45,44.87605282,3764,103,14371.55,864,1460,667,97,256,61,1396,64,623,44,82,15
610000,2014,32953,329.53,2435,46167,17689.94,46.2236962,3775,101.6,15836.75,1020,173,104,67,61,31,145,28,89,15,59,8
610000,2015,38274,382.74,2904,47301,18021.86,49.72317427,3793,101,17394.98,1328,813,333,622,63,743,164,649,75,258,137,485
610000,2016,44575,445.75,3659,50081,19165.39,52.16365067,3813,101.3,18874,580,810,199,783,105,487,130,680,72,127,202,581
610000,2017,51900.62,519.0062,4603,56154,21898.81,52.99391986,3835,101.6,20635,686,2103,1976,777,85,82,353,1750,187,1789,204,573
610000,2018,62600,626,5789,62195,24438.32,55,3864,102.1,22528,654,113021,7019,24836,1052,756,2421,110600,2038,4981,6713,18123
610000,2019,70200,702,6978.87,66649,25793.17,58.89198783,3876.21,102.9,24666,,20545,19922,56391,2202,1234,15579,4966,15754,4168,44926,11464
610000,2020,,,,66292,26181.86,65.14538559,,102.5,,,156133,126788,1553270,2138,6020,46339,109794,21584,105204,223011,1330259
620000,2013,10068.4,100.68,619,23313,6330.69,34.62190862,2582,103.2,10954.4,90,4137,1133,734,231,51,3441,696,946,187,569,165
620000,2014,12660.2,126.602,780,25202,6836.82,36.70709207,2591,102.1,12184.71,94,6281,1339,1885,94,29,4611,1670,1030,309,1647,238
620000,2015,15632.88,156.3288,975,25264,6790.32,38.6605374,2599.55,101.6,13466.59,95,2326,648,1789,53,20,1786,540,474,174,1183,606
620000,2016,19089.4,190.894,1219,26520,7152.04,42.18390805,2610,101.3,14670,93,10073,3057,11841,119,73,6462,3611,1780,1277,6984,4857
620000,2017,23889.4,238.894,1579,28026,7459.9,44.00485964,2626,101.4,16011,121,12936,3110,16439,278,139,8856,4080,1988,1122,10178,6261
620000,2018,30190.9,301.909,2058.3,30797,8246.07,46,2637,102,17488,128,58604,26679,150186,418,117,29377,29227,14275,12404,66306,83880
620000,2019,37000,370,2676,32995,8718.3,56.0263053,2647.43,102.3,19139,,165434,75923,704952,3112,1558,138756,26611,64103,11805,634951,69923
620000,2020,,,,35995,9016.7,58.40063974,,102,,,214737,119430,1068982,2278,5856,90069,124668,31429,88001,275161,793821
630000,2013,1775.78,17.76,157,29772,2122.06,47.42207376,578,103.9,12947.84,16,242,124,119,91,19,65,177,41,83,36,83
630000,2014,2000.43,20.0043,200,31824,2303.32,49.53549758,583,102.8,14373.98,20,128,140,319,37,20,54,74,84,56,203,116
630000,2015,2308.84,23.0884,246,34322,2417.05,54.04211206,588.43,102.6,15812.7,21,25,17,21,6,8,22,3,14,3,18,3
630000,2016,2869.91,28.6991,307,38213,2572.49,53.96290051,593,101.8,17302,15,163,54,142,232,545,34,129,10,44,69,73
630000,2017,3477.08,34.7708,379,41366,2624.83,52.96634246,598,101.5,19001,14,660,459,1042,609,808,468,192,329,130,794,248
630000,2018,4197.46,41.9746,464,45738,2865.23,54,603,102.5,20757,13,65,54,122,93,120,56,9,33,21,69,53
630000,2019,5072.86,50.7286,559.03,48570,2965.95,64.79661017,607.82,102.5,22618,,12235,4520,19805,361,969,8971,3264,2402,2118,6105,13700
630000,2020,,,,50819,3005.92,69.61214165,,102.6,,,19839,30541,336845,455,2970,944,18895,617,29924,3454,333391
640000,2011,1167.7,11.68,83.81,30365,2102.21,32.37156932,639,106.3,11475.43609,57,74,22,0,25,15,46,28,17,5,0,0
640000,2012,1338.99,13.39,103.05,33125,2341.29,39.86464562,647,102,13100.79583,67,181,122,0,47,51,107,74,84,38,0,0
640000,2013,1817.88,18.18,126.55,35772,2577.57,43.25960348,654,103.4,14565.78,69,99,69,7,63,127,39,60,44,25,2,5
640000,2014,1671.62,16.7162,141.56,37605,2752.1,44.59291955,662,101.9,15906.78,66,448,311,94,104,184,215,233,152,159,43,51
640000,2015,1835.75,18.3575,160.01,38805,2911.77,48.81116368,667.88,101.1,17329.09,67,84,117,110,115,51,76,8,98,19,74,36
640000,2016,2149.55,21.4955,207.33,41427,3150.06,50.22222222,675,101.5,18832,51,25,20,32,61,52,8,17,9,11,17,15
640000,2017,3078.52,30.7852,275.22,47177,3443.56,51.01570865,682,101.6,20562,80,44,28,74,116,65,24,20,11,17,47,27
640000,2018,3335.88,33.3588,291.9,51248,3705.18,52,688,102.3,22400,57,41,24,46,33,13,17,24,22,2,41,5
640000,2019,3998.5423,39.985423,335.56,54217,3748.48,72.52440725,694.66,102.1,24412,,35,13,73,32,20,27,8,11,2,51,22
640000,2020,,,,54528,3920.55,76.28294036,,101.5,,,43086,162811,579462,12,64,1,43085,1,162810,1,579461
650000,2013,5048.86,50.49,637.38,37325,8443.84,48.31515259,2264,103.9,13669.62,120,22,30,9,64,51,17,5,19,11,6,3
650000,2015,5929,59.29,985,39959,9324.8,53.48069483,2359.73,100.6,16859.11,111,0,0,2,0,2,0,0,0,0,0,2
650000,2018,14762.3,147.623,2497,51950,12199.08,55,2487,102,21500,129,2,1,3,7,6,2,0,0,1,1,2
650000,2019,21151,211.51,3593.5,54280,13597.11,71.08245408,2523.22,101.9,23103,,316,217,847,437,51,293,23,197,20,796,51
650000,2020,505,5.05,991,53593,13797.58,75.05019305,,101.5,,,57645,84140,557273,70,277,2090,55555,2169,81971,13545,543728
